행정구역,연도,총인구수,세대수,세대당 인구,남자 인구수,여자 인구수,남여 비율
원주시,2008년,303975,116514,2.61,151626,152349,1
춘천시,2008년,261975,101758,2.57,129339,132636,0.98
강릉시,2008년,218399,86939,2.51,108842,109557,0.99
동해시,2008년,95652,37512,2.55,48383,47269,1.02
속초시,2008년,84599,35615,2.38,41676,42923,0.97
삼척시,2008년,70954,29736,2.39,35940,35014,1.03
홍천군,2008년,70360,28486,2.47,35824,34536,1.04
태백시,2008년,51028,21131,2.41,26065,24963,1.04
철원군,2008년,47724,18756,2.54,24744,22980,1.08
평창군,2008년,43706,18712,2.34,22415,21291,1.05
횡성군,2008년,43413,17942,2.42,22173,21240,1.04
정선군,2008년,41269,18292,2.26,21403,19866,1.08
영월군,2008년,40201,17529,2.29,20422,19779,1.03
인제군,2008년,31620,12977,2.44,16545,15075,1.1
고성군,2008년,30172,13136,2.3,15384,14788,1.04
양양군,2008년,28115,12227,2.3,14276,13839,1.03
화천군,2008년,24110,10813,2.23,13078,11032,1.19
양구군,2008년,21303,8875,2.4,11147,10156,1.1
원주시,2009년,307882,119306,2.58,153495,154387,0.99
춘천시,2009년,264849,104022,2.55,130791,134058,0.98
강릉시,2009년,217464,87636,2.48,108146,109318,0.99
동해시,2009년,95271,38053,2.5,48202,47069,1.02
속초시,2009년,83822,35787,2.34,41260,42562,0.97
삼척시,2009년,71935,31233,2.3,36490,35445,1.03
홍천군,2009년,69606,28707,2.42,35537,34069,1.04
태백시,2009년,50424,21182,2.38,25746,24678,1.04
철원군,2009년,47669,18889,2.52,24573,23096,1.06
횡성군,2009년,44121,18491,2.39,22543,21578,1.04
평창군,2009년,43634,19027,2.29,22394,21240,1.05
정선군,2009년,40708,18417,2.21,21123,19585,1.08
영월군,2009년,40265,17945,2.24,20468,19797,1.03
인제군,2009년,31452,13015,2.42,16382,15070,1.09
고성군,2009년,30272,13562,2.23,15578,14694,1.06
양양군,2009년,27957,12394,2.26,14226,13731,1.04
화천군,2009년,24216,11038,2.19,13181,11035,1.19
양구군,2009년,21323,8989,2.37,11135,10188,1.09
원주시,2010년,314678,123983,2.54,156741,157937,0.99
춘천시,2010년,269950,108140,2.5,133275,136675,0.98
강릉시,2010년,218503,89984,2.43,108613,109890,0.99
동해시,2010년,95236,38932,2.45,48170,47066,1.02
속초시,2010년,84302,36671,2.3,41543,42759,0.97
삼척시,2010년,72046,32482,2.22,36367,35679,1.02
홍천군,2010년,69893,29280,2.39,35595,34298,1.04
태백시,2010년,50864,22292,2.28,25987,24877,1.04
철원군,2010년,48928,20316,2.41,25543,23385,1.09
횡성군,2010년,44254,18960,2.33,22528,21726,1.04
평창군,2010년,43622,19392,2.25,22375,21247,1.05
정선군,2010년,41045,19210,2.14,21286,19759,1.08
영월군,2010년,40407,18505,2.18,20574,19833,1.04
인제군,2010년,31842,13528,2.35,16717,15125,1.11
고성군,2010년,30112,13975,2.15,15590,14522,1.07
양양군,2010년,27929,12574,2.22,14242,13687,1.04
화천군,2010년,24364,11370,2.14,13260,11104,1.19
양구군,2010년,21843,9407,2.32,11401,10442,1.09
원주시,2011년,320536,128436,2.5,159522,161014,0.99
춘천시,2011년,272805,110075,2.48,134600,138205,0.97
강릉시,2011년,217571,90090,2.42,108294,109277,0.99
동해시,2011년,95804,39411,2.43,48289,47515,1.02
속초시,2011년,83745,36579,2.29,41260,42485,0.97
삼척시,2011년,72312,33388,2.17,36681,35631,1.03
홍천군,2011년,69899,29648,2.36,35639,34260,1.04
태백시,2011년,50176,22230,2.26,25520,24656,1.04
철원군,2011년,48084,19970,2.41,24949,23135,1.08
횡성군,2011년,44360,19160,2.32,22576,21784,1.04
평창군,2011년,43577,19569,2.23,22334,21243,1.05
영월군,2011년,40199,18668,2.15,20480,19719,1.04
정선군,2011년,40181,18968,2.12,20815,19366,1.07
인제군,2011년,31970,13935,2.29,17014,14956,1.14
고성군,2011년,30057,14248,2.11,15635,14422,1.08
양양군,2011년,27942,12783,2.19,14282,13660,1.05
화천군,2011년,24945,11716,2.13,13630,11315,1.2
양구군,2011년,22285,9775,2.28,11758,10527,1.12
원주시,2012년,323885,130617,2.48,161117,162768,0.99
춘천시,2012년,273364,110596,2.47,134874,138490,0.97
강릉시,2012년,217741,91332,2.38,108318,109423,0.99
동해시,2012년,93897,39002,2.41,47387,46510,1.02
속초시,2012년,83579,36745,2.27,41165,42414,0.97
삼척시,2012년,72463,34066,2.13,36847,35616,1.03
홍천군,2012년,69727,29894,2.33,35548,34179,1.04
태백시,2012년,49493,22258,2.22,25123,24370,1.03
철원군,2012년,47968,19975,2.4,24776,23192,1.07
횡성군,2012년,44615,19461,2.29,22676,21939,1.03
평창군,2012년,43627,19783,2.21,22305,21322,1.05
영월군,2012년,40155,18881,2.13,20448,19707,1.04
정선군,2012년,39915,19058,2.09,20686,19229,1.08
인제군,2012년,32456,14348,2.26,17379,15077,1.15
고성군,2012년,30124,14663,2.05,15792,14332,1.1
양양군,2012년,27802,12885,2.16,14169,13633,1.04
화천군,2012년,25020,11686,2.14,13575,11445,1.19
양구군,2012년,22799,10051,2.27,12088,10711,1.13
원주시,2013년,324837,132207,2.46,161588,163249,0.99
춘천시,2013년,274455,111313,2.47,135377,139078,0.97
강릉시,2013년,216806,92412,2.35,107689,109117,0.99
동해시,2013년,95143,40093,2.37,48104,47039,1.02
속초시,2013년,83109,36946,2.25,40929,42180,0.97
삼척시,2013년,73023,35362,2.07,37384,35639,1.05
홍천군,2013년,70638,30885,2.29,36181,34457,1.05
태백시,2013년,48794,22204,2.2,24783,24011,1.03
철원군,2013년,47473,19835,2.39,24418,23055,1.06
횡성군,2013년,44937,19960,2.25,22866,22071,1.04
평창군,2013년,43666,20030,2.18,22298,21368,1.04
영월군,2013년,40150,19111,2.1,20478,19672,1.04
정선군,2013년,39985,19330,2.07,20675,19310,1.07
인제군,2013년,32517,14474,2.25,17345,15172,1.14
고성군,2013년,30398,15377,1.98,16184,14214,1.14
양양군,2013년,27659,13133,2.11,14130,13529,1.04
화천군,2013년,25079,11734,2.14,13529,11550,1.17
양구군,2013년,23594,10507,2.25,12540,11054,1.13
원주시,2014년,327292,134487,2.43,162734,164558,0.99
춘천시,2014년,275791,113095,2.44,136017,139774,0.97
강릉시,2014년,215807,93007,2.32,107149,108658,0.99
동해시,2014년,94562,40208,2.35,47850,46712,1.02
속초시,2014년,82432,37032,2.23,40590,41842,0.97
삼척시,2014년,72314,35204,2.05,36940,35374,1.04
홍천군,2014년,70451,31183,2.26,35996,34455,1.04
태백시,2014년,48258,22352,2.16,24509,23749,1.03
철원군,2014년,47590,20337,2.34,24676,22914,1.08
횡성군,2014년,45373,20348,2.23,23019,22354,1.03
평창군,2014년,43660,20279,2.15,22257,21403,1.04
영월군,2014년,40191,19597,2.05,20581,19610,1.05
정선군,2014년,39425,19347,2.04,20387,19038,1.07
인제군,2014년,32475,14613,2.22,17287,15188,1.14
고성군,2014년,30269,15408,1.96,16107,14162,1.14
양양군,2014년,27521,13229,2.08,14005,13516,1.04
화천군,2014년,27143,13474,2.01,15168,11975,1.27
양구군,2014년,23888,10778,2.22,12735,11153,1.14
원주시,2015년,332995,138380,2.41,165547,167448,0.99
춘천시,2015년,277997,115044,2.42,136974,141023,0.97
강릉시,2015년,214560,93774,2.29,106545,108015,0.99
동해시,2015년,93895,40338,2.33,47503,46392,1.02
속초시,2015년,81992,37084,2.21,40377,41615,0.97
삼척시,2015년,70839,34601,2.05,36000,34839,1.03
홍천군,2015년,70336,31443,2.24,35906,34430,1.04
철원군,2015년,48799,22017,2.22,25971,22828,1.14
태백시,2015년,47501,22293,2.13,24128,23373,1.03
횡성군,2015년,45777,20821,2.2,23260,22517,1.03
평창군,2015년,43500,20601,2.11,22204,21296,1.04
영월군,2015년,40216,19990,2.01,20691,19525,1.06
정선군,2015년,39197,19519,2.01,20253,18944,1.07
인제군,2015년,33255,15594,2.13,18020,15235,1.18
고성군,2015년,30060,15324,1.96,15981,14079,1.14
양양군,2015년,27479,13374,2.05,13965,13514,1.03
화천군,2015년,27020,13668,1.98,15173,11847,1.28
양구군,2015년,24089,11140,2.16,12936,11153,1.16
원주시,2016년,337979,142136,2.38,167854,170125,0.99
춘천시,2016년,280707,117014,2.4,138251,142456,0.97
강릉시,2016년,213846,94781,2.26,106231,107615,0.99
동해시,2016년,93297,40468,2.31,47166,46131,1.02
속초시,2016년,81793,37193,2.2,40288,41505,0.97
홍천군,2016년,70076,31851,2.2,35738,34338,1.04
삼척시,2016년,69599,34147,2.04,35253,34346,1.03
철원군,2016년,48013,21778,2.2,25429,22584,1.13
태백시,2016년,47070,22265,2.11,23899,23171,1.03
횡성군,2016년,45991,21283,2.16,23398,22593,1.04
평창군,2016년,43318,20745,2.09,22126,21192,1.04
영월군,2016년,40073,20255,1.98,20652,19421,1.06
정선군,2016년,38718,19571,1.98,19975,18743,1.07
인제군,2016년,32720,15426,2.12,17677,15043,1.18
고성군,2016년,30114,15377,1.96,15899,14215,1.12
양양군,2016년,27218,13402,2.03,13838,13380,1.03
화천군,2016년,26264,13207,1.99,14554,11710,1.24
양구군,2016년,24010,11355,2.11,12918,11092,1.16
원주시,2017년,341337,145521,2.35,169742,171595,0.99
춘천시,2017년,280514,118450,2.37,138159,142355,0.97
강릉시,2017년,213952,95963,2.23,106286,107666,0.99
동해시,2017년,92851,40730,2.28,47067,45784,1.03
속초시,2017년,82273,37772,2.18,40531,41742,0.97
홍천군,2017년,70340,32467,2.17,35855,34485,1.04
삼척시,2017년,68514,33863,2.02,34638,33876,1.02
철원군,2017년,47185,21583,2.19,24886,22299,1.12
횡성군,2017년,46281,21777,2.13,23541,22740,1.04
태백시,2017년,45888,21889,2.1,23196,22692,1.02
평창군,2017년,43092,21008,2.05,22021,21071,1.05
영월군,2017년,40067,20715,1.93,20639,19428,1.06
정선군,2017년,38173,19554,1.95,19748,18425,1.07
인제군,2017년,32582,15523,2.1,17579,15003,1.17
고성군,2017년,30029,15519,1.93,15817,14212,1.11
양양군,2017년,27207,13526,2.01,13849,13358,1.04
화천군,2017년,26022,13065,1.99,14313,11709,1.22
양구군,2017년,23835,11340,2.1,12768,11067,1.15
원주시,2018년,344070,149166,2.31,171048,173022,0.99
춘천시,2018년,280640,120190,2.33,138243,142397,0.97
강릉시,2018년,212957,96859,2,105697,107260,0.99
동해시,2018년,91272,40784,2.24,46212,45060,1.03
속초시,2018년,81682,37993,2.15,40248,41434,0.97
홍천군,2018년,69949,32760,2.14,35671,34278,1.04
삼척시,2018년,68326,34227,2,34587,33739,1.03
횡성군,2018년,46726,22411,2.08,23828,22898,1.04
철원군,2018년,46413,21451,2.16,24408,22005,1.11
태백시,2018년,44858,21832,2.05,22612,22246,1.02
평창군,2018년,42610,21172,2.01,21771,20839,1.04
영월군,2018년,39730,21011,1.89,20493,19237,1.07
정선군,2018년,37700,19761,1.91,19595,18105,1.08
인제군,2018년,32136,15550,2.07,17349,14787,1.17
고성군,2018년,28144,14763,1.91,14729,13415,1.1
양양군,2018년,27347,13693,2,13900,13447,1.03
화천군,2018년,25084,12564,2,13603,11481,1.18
양구군,2018년,23408,11058,2.12,12462,10946,1.14
원주시,2019년,349215,154583,2.26,173425,175790,0.99
춘천시,2019년,281291,123006,2.29,138700,142591,0.97
강릉시,2019년,213442,99086,2.15,105893,107549,0.98
동해시,2019년,90522,41141,2.2,45845,44677,1.03
속초시,2019년,81786,38689,2.11,40420,41366,0.98
홍천군,2019년,69150,33142,2.09,35359,33791,1.05
삼척시,2019년,67228,34082,1.97,34038,33190,1.03
횡성군,2019년,46575,22832,2.04,23785,22790,1.04
철원군,2019년,45584,21216,2.15,23767,21817,1.09
태백시,2019년,43866,21798,2.01,22168,21698,1.02
평창군,2019년,42106,21379,1.97,21550,20556,1.05
영월군,2019년,39127,21044,1.86,20143,18984,1.06
정선군,2019년,37271,19974,1.87,19360,17911,1.08
인제군,2019년,31672,15583,2.03,17143,14529,1.18
양양군,2019년,27726,14081,1.97,14099,13627,1.03
고성군,2019년,27260,14445,1.89,14114,13146,1.07
화천군,2019년,24917,12603,1.98,13495,11422,1.18
양구군,2019년,22764,10840,2.1,12082,10682,1.13
원주시,2020년,354376,160307,2.21,175939,178437,0.99
춘천시,2020년,282765,126685,2.23,139576,143189,0.97
강릉시,2020년,213321,101424,2.1,105794,107527,0.98
동해시,2020년,90593,42306,2.14,45991,44602,1.03
속초시,2020년,82665,39932,2.07,40965,41700,0.98
홍천군,2020년,69242,34187,2.03,35663,33579,1.06
삼척시,2020년,65243,33635,1.94,33011,32232,1.02
횡성군,2020년,46472,23276,2,23822,22650,1.05
철원군,2020년,44699,21182,2.11,23216,21483,1.08
태백시,2020년,42719,21588,1.98,21640,21079,1.03
평창군,2020년,41681,21618,1.93,21321,20360,1.05
영월군,2020년,38662,21246,1.82,19986,18676,1.07
정선군,2020년,36870,20230,1.82,19174,17696,1.08
인제군,2020년,31694,15900,1.99,17084,14610,1.17
양양군,2020년,27946,14549,1.92,14220,13726,1.04
고성군,2020년,26757,14546,1.84,13802,12955,1.07
화천군,2020년,24857,12862,1.93,13472,11385,1.18
양구군,2020년,22278,10828,2.06,11829,10449,1.13
원주시,2021년,357757,164895,2.17,177396,180361,0.98
춘천시,2021년,284594,130277,2.18,140584,144010,0.98
강릉시,2021년,212965,102879,2.07,105667,107298,0.98
동해시,2021년,90081,42916,2.1,45795,44286,1.03
속초시,2021년,82791,40706,2.03,41080,41711,0.98
홍천군,2021년,68365,34237,2,35184,33181,1.06
삼척시,2021년,63429,33184,1.91,32043,31386,1.02
횡성군,2021년,46481,23593,1.97,23859,22622,1.05
철원군,2021년,43340,20862,2.08,22453,20887,1.07
평창군,2021년,40996,21665,1.89,21091,19905,1.06
태백시,2021년,40844,20731,1.97,20656,20188,1.02
영월군,2021년,37904,21143,1.79,19626,18278,1.07
정선군,2021년,35675,19713,1.81,18565,17110,1.09
인제군,2021년,32165,16380,1.96,17461,14704,1.19
양양군,2021년,27913,14759,1.89,14251,13662,1.04
고성군,2021년,27249,15064,1.81,14019,13230,1.06
화천군,2021년,24195,12556,1.93,13138,11057,1.19
양구군,2021년,21748,10660,2.04,11464,10284,1.11
원주시,2022년,360807,168755,2.14,178880,181927,0.98
춘천시,2022년,286664,133668,2.14,141490,145174,0.97
강릉시,2022년,211381,103352,2.05,104845,106536,0.98
동해시,2022년,89426,43251,2.07,45423,44003,1.03
속초시,2022년,82806,41193,2.01,41037,41769,0.98
홍천군,2022년,67977,34510,1.97,34954,33023,1.06
삼척시,2022년,63455,33715,1.88,32156,31299,1.03
횡성군,2022년,46532,23767,1.96,23877,22655,1.05
철원군,2022년,42256,20605,2.05,21863,20393,1.07
평창군,2022년,40990,21927,1.87,21176,19814,1.07
태백시,2022년,39428,20324,1.94,19881,19547,1.02
영월군,2022년,37728,21288,1.77,19509,18219,1.07
정선군,2022년,34931,19533,1.79,18264,16667,1.1
인제군,2022년,32206,16631,1.94,17529,14677,1.19
양양군,2022년,27866,14948,1.86,14228,13638,1.04
고성군,2022년,27274,15291,1.78,14060,13214,1.06
화천군,2022년,23388,12114,1.93,12560,10828,1.16
양구군,2022년,21383,10609,2.02,11215,10168,1.1
원주시,2023년,361503,171275,2.11,179115,182388,0.98
춘천시,2023년,286426,135498,2.11,141419,145007,0.98
강릉시,2023년,209439,103682,2.02,103759,105680,0.98
동해시,2023년,88625,43361,2.04,45045,43580,1.03
속초시,2023년,82054,41330,1.99,40620,41434,0.98
홍천군,2023년,67309,34594,1.95,34655,32654,1.06
삼척시,2023년,62651,33700,1.86,31822,30829,1.03
횡성군,2023년,46359,23908,1.94,23826,22533,1.06
철원군,2023년,41448,20501,2.02,21478,19970,1.08
평창군,2023년,40659,21993,1.85,21056,19603,1.07
태백시,2023년,38702,20377,1.9,19476,19226,1.01
영월군,2023년,37332,21276,1.75,19318,18014,1.07
정선군,2023년,34202,19287,1.77,17844,16358,1.09
인제군,2023년,32020,16787,1.91,17422,14598,1.19
양양군,2023년,27710,15039,1.84,14192,13518,1.05
고성군,2023년,27305,15431,1.77,14018,13287,1.06
화천군,2023년,23007,12052,1.91,12321,10686,1.15
양구군,2023년,21056,10544,2,11063,9993,1.11
원주시,2024년,362164,173625,2.09,179228,182936,0.98
춘천시,2024년,286069,137157,2.09,141225,144844,0.98
강릉시,2024년,207731,104223,1.99,102890,104841,0.98
동해시,2024년,87675,43606,2.01,44495,43180,1.03
속초시,2024년,80933,41278,1.96,39931,41002,0.97
홍천군,2024년,66717,34889,1.91,34423,32294,1.07
삼척시,2024년,61735,33687,1.83,31437,30298,1.04
횡성군,2024년,46111,24048,1.92,23703,22408,1.06
철원군,2024년,40497,20270,2,20922,19575,1.07
평창군,2024년,40396,22080,1.83,20955,19441,1.08
태백시,2024년,37936,20246,1.87,19180,18756,1.02
영월군,2024년,36721,21139,1.74,18990,17731,1.07
정선군,2024년,33515,19124,1.75,17475,16040,1.09
인제군,2024년,31535,16709,1.89,17194,14341,1.2
양양군,2024년,27489,15000,1.83,14079,13410,1.05
고성군,2024년,26999,15331,1.76,13841,13158,1.05
화천군,2024년,22922,12055,1.9,12283,10639,1.15
양구군,2024년,20621,10367,1.99,10774,9847,1.09
