행정구역,연도,총인구수,세대수,세대당 인구,남자 인구수,여자 인구수,남여 비율
포항시,2008년,508119 ,187079 ,2.72,258441 ,249678 ,1.04
구미시,2008년,393959 ,149224 ,2.64,200203 ,193756 ,1.03
경주시,2008년,269343 ,105579 ,2.55,134663 ,134680 ,1
포항시 북구,2008년,254348 ,92491 ,2.75,127686 ,126662 ,1.01
포항시 남구,2008년,253771 ,94588 ,2.68,130755 ,123016 ,1.06
경산시,2008년,237423 ,90779 ,2.62,119731 ,117692 ,1.02
안동시,2008년,167300 ,65849 ,2.54,83145 ,84155 ,0.99
김천시,2008년,138056 ,53071 ,2.6,68569 ,69487 ,0.99
칠곡군,2008년,116472 ,46821 ,2.49,60060 ,56412 ,1.06
영주시,2008년,113930 ,44843 ,2.54,56785 ,57145 ,0.99
상주시,2008년,105381 ,43432 ,2.43,51844 ,53537 ,0.97
영천시,2008년,104022 ,43571 ,2.39,52090 ,51932 ,1
문경시,2008년,75486 ,31071 ,2.43,37277 ,38209 ,0.98
의성군,2008년,60033 ,26813 ,2.24,29591 ,30442 ,0.97
울진군,2008년,53042 ,23091 ,2.3,26110 ,26932 ,0.97
예천군,2008년,47993 ,21021 ,2.28,23780 ,24213 ,0.98
성주군,2008년,45024 ,19325 ,2.33,22978 ,22046 ,1.04
청도군,2008년,44711 ,19428 ,2.3,21744 ,22967 ,0.95
영덕군,2008년,42707 ,19717 ,2.17,20284 ,22423 ,0.9
고령군,2008년,34770 ,14944 ,2.33,17734 ,17036 ,1.04
봉화군,2008년,34628 ,15288 ,2.27,17346 ,17282 ,1
청송군,2008년,27289 ,12495 ,2.18,13548 ,13741 ,0.99
군위군,2008년,25309 ,11625 ,2.18,12740 ,12569 ,1.01
영양군,2008년,18766 ,8460 ,2.22,9250 ,9516 ,0.97
울릉군,2008년,10168 ,4573 ,2.22,5286 ,4882 ,1.08
포항시,2009년,509475 ,190790 ,2.67,259082 ,250393 ,1.03
구미시,2009년,396419 ,151440 ,2.62,201402 ,195017 ,1.03
경주시,2009년,267466 ,106571 ,2.51,133819 ,133647 ,1
포항시 북구,2009년,256891 ,94750 ,2.71,128878 ,128013 ,1.01
포항시 남구,2009년,252584 ,96040 ,2.63,130204 ,122380 ,1.06
경산시,2009년,236459 ,91529 ,2.58,119284 ,117175 ,1.02
안동시,2009년,167432 ,66870 ,2.5,82991 ,84441 ,0.98
김천시,2009년,135918 ,53122 ,2.56,67446 ,68472 ,0.99
칠곡군,2009년,117288 ,48219 ,2.43,60228 ,57060 ,1.06
영주시,2009년,113309 ,45397 ,2.5,56481 ,56828 ,0.99
상주시,2009년,106208 ,44549 ,2.38,52321 ,53887 ,0.97
영천시,2009년,103115 ,43964 ,2.35,51813 ,51302 ,1.01
문경시,2009년,76645 ,32082 ,2.39,37764 ,38881 ,0.97
의성군,2009년,59109 ,26941 ,2.19,29102 ,30007 ,0.97
울진군,2009년,52529 ,23309 ,2.25,25857 ,26672 ,0.97
예천군,2009년,47306 ,21200 ,2.23,23427 ,23879 ,0.98
성주군,2009년,45616 ,19839 ,2.3,23286 ,22330 ,1.04
청도군,2009년,44279 ,19682 ,2.25,21564 ,22715 ,0.95
영덕군,2009년,41710 ,19790 ,2.11,19809 ,21901 ,0.9
고령군,2009년,34535 ,15049 ,2.29,17597 ,16938 ,1.04
봉화군,2009년,34297 ,15413 ,2.23,17162 ,17135 ,1
청송군,2009년,26917 ,12595 ,2.14,13379 ,13538 ,0.99
군위군,2009년,24966 ,11673 ,2.14,12587 ,12379 ,1.02
영양군,2009년,18553 ,8495 ,2.18,9183 ,9370 ,0.98
울릉군,2009년,10325 ,4848 ,2.13,5393 ,4932 ,1.09
포항시,2010년,514755 ,196411 ,2.62,261586 ,253169 ,1.03
구미시,2010년,404920 ,157057 ,2.58,206195 ,198725 ,1.04
경주시,2010년,267098 ,108567 ,2.46,133646 ,133452 ,1
포항시 북구,2010년,260467 ,97763 ,2.66,130461 ,130006 ,1
포항시 남구,2010년,254288 ,98648 ,2.58,131125 ,123163 ,1.06
경산시,2010년,240708 ,94447 ,2.55,121560 ,119148 ,1.02
안동시,2010년,167886 ,68075 ,2.47,83013 ,84873 ,0.98
김천시,2010년,136136 ,54693 ,2.49,67573 ,68563 ,0.99
칠곡군,2010년,119087 ,49729 ,2.39,61314 ,57773 ,1.06
영주시,2010년,113926 ,46744 ,2.44,56713 ,57213 ,0.99
상주시,2010년,105607 ,44981 ,2.35,52081 ,53526 ,0.97
영천시,2010년,103190 ,44857 ,2.3,51895 ,51295 ,1.01
문경시,2010년,77391 ,33161 ,2.33,38036 ,39355 ,0.97
의성군,2010년,58832 ,27475 ,2.14,28885 ,29947 ,0.96
울진군,2010년,52430 ,23666 ,2.22,25778 ,26652 ,0.97
예천군,2010년,47049 ,21490 ,2.19,23246 ,23803 ,0.98
성주군,2010년,45289 ,20092 ,2.25,23072 ,22217 ,1.04
청도군,2010년,44391 ,20177 ,2.2,21627 ,22764 ,0.95
영덕군,2010년,41377 ,20140 ,2.05,19657 ,21720 ,0.91
고령군,2010년,34678 ,15417 ,2.25,17682 ,16996 ,1.04
봉화군,2010년,34567 ,15843 ,2.18,17292 ,17275 ,1
청송군,2010년,26715 ,12740 ,2.1,13213 ,13502 ,0.98
군위군,2010년,24736 ,11791 ,2.1,12436 ,12300 ,1.01
영양군,2010년,18451 ,8681 ,2.13,9080 ,9371 ,0.97
울릉군,2010년,10701 ,5252 ,2.04,5622 ,5079 ,1.11
포항시,2011년,517088 ,199120 ,2.6,262648 ,254440 ,1.03
구미시,2011년,413446 ,161502 ,2.56,210447 ,202999 ,1.04
경주시,2011년,265488 ,108945 ,2.44,132822 ,132666 ,1
포항시 북구,2011년,264532 ,100129 ,2.64,132432 ,132100 ,1
포항시 남구,2011년,252556 ,98991 ,2.55,130216 ,122340 ,1.06
경산시,2011년,243684 ,96241 ,2.53,123114 ,120570 ,1.02
안동시,2011년,168157 ,68766 ,2.45,83037 ,85120 ,0.98
김천시,2011년,136185 ,55334 ,2.46,67528 ,68657 ,0.98
칠곡군,2011년,118838 ,49961 ,2.38,61458 ,57380 ,1.07
영주시,2011년,114148 ,47446 ,2.41,56759 ,57389 ,0.99
상주시,2011년,104685 ,45047 ,2.32,51569 ,53116 ,0.97
영천시,2011년,104182 ,45765 ,2.28,52547 ,51635 ,1.02
문경시,2011년,76727 ,33226 ,2.31,37632 ,39095 ,0.96
의성군,2011년,57744 ,27370 ,2.11,28329 ,29415 ,0.96
울진군,2011년,52045 ,23652 ,2.2,25504 ,26541 ,0.96
예천군,2011년,46579 ,21430 ,2.17,22938 ,23641 ,0.97
성주군,2011년,45640 ,20428 ,2.23,23286 ,22354 ,1.04
청도군,2011년,44298 ,20397 ,2.17,21552 ,22746 ,0.95
영덕군,2011년,40794 ,20051 ,2.03,19378 ,21416 ,0.9
고령군,2011년,35455 ,15911 ,2.23,18102 ,17353 ,1.04
봉화군,2011년,34192 ,15825 ,2.16,17099 ,17093 ,1
청송군,2011년,26569 ,12827 ,2.07,13162 ,13407 ,0.98
군위군,2011년,24268 ,11647 ,2.08,12200 ,12068 ,1.01
영양군,2011년,18241 ,8688 ,2.1,8982 ,9259 ,0.97
울릉군,2011년,10742 ,5322 ,2.02,5634 ,5108 ,1.1
포항시,2012년,518913 ,202148 ,2.57,263576 ,255337 ,1.03
구미시,2012년,416949 ,163030 ,2.56,212041 ,204908 ,1.03
포항시 북구,2012년,267479 ,102402 ,2.61,133890 ,133589 ,1
경주시,2012년,264091 ,109675 ,2.41,132100 ,131991 ,1
포항시 남구,2012년,251434 ,99746 ,2.52,129686 ,121748 ,1.07
경산시,2012년,246358 ,98130 ,2.51,124367 ,121991 ,1.02
안동시,2012년,168302 ,69617 ,2.42,83091 ,85211 ,0.98
김천시,2012년,135504 ,55964 ,2.42,67317 ,68187 ,0.99
칠곡군,2012년,119786 ,50792 ,2.36,62001 ,57785 ,1.07
영주시,2012년,113547 ,47908 ,2.37,56442 ,57105 ,0.99
상주시,2012년,104182 ,45174 ,2.31,51259 ,52923 ,0.97
영천시,2012년,101798 ,45328 ,2.25,51337 ,50461 ,1.02
문경시,2012년,75899 ,33357 ,2.28,37319 ,38580 ,0.97
의성군,2012년,57043 ,27407 ,2.08,27932 ,29111 ,0.96
울진군,2012년,51844 ,23864 ,2.17,25507 ,26337 ,0.97
예천군,2012년,46027 ,21378 ,2.15,22640 ,23387 ,0.97
성주군,2012년,45127 ,20395 ,2.21,23138 ,21989 ,1.05
청도군,2012년,43968 ,20578 ,2.14,21398 ,22570 ,0.95
영덕군,2012년,40257 ,19919 ,2.02,19136 ,21121 ,0.91
고령군,2012년,35343 ,15983 ,2.21,18046 ,17297 ,1.04
봉화군,2012년,33934 ,15874 ,2.14,16903 ,17031 ,0.99
청송군,2012년,26481 ,12885 ,2.06,13075 ,13406 ,0.98
군위군,2012년,24119 ,11671 ,2.07,12059 ,12060 ,1
영양군,2012년,18208 ,8725 ,2.09,8969 ,9239 ,0.97
울릉군,2012년,10673 ,5393 ,1.98,5641 ,5032 ,1.12
포항시,2013년,519467 ,204857 ,2.54,263461 ,256006 ,1.03
구미시,2013년,419428 ,165018 ,2.54,213652 ,205776 ,1.04
포항시 북구,2013년,269758 ,104426 ,2.58,134774 ,134984 ,1
경주시,2013년,263283 ,111053 ,2.37,131725 ,131558 ,1
포항시 남구,2013년,249709 ,100431 ,2.49,128687 ,121022 ,1.06
경산시,2013년,248805 ,100272 ,2.48,125454 ,123351 ,1.02
안동시,2013년,168461 ,70674 ,2.38,83229 ,85232 ,0.98
김천시,2013년,135259 ,56681 ,2.39,67222 ,68037 ,0.99
칠곡군,2013년,121182 ,52053 ,2.33,62805 ,58377 ,1.08
영주시,2013년,112625 ,48324 ,2.33,56102 ,56523 ,0.99
상주시,2013년,103346 ,45413 ,2.28,50785 ,52561 ,0.97
영천시,2013년,100778 ,45605 ,2.21,50743 ,50035 ,1.01
문경시,2013년,75664 ,33674 ,2.25,37164 ,38500 ,0.97
의성군,2013년,56064 ,27316 ,2.05,27399 ,28665 ,0.96
울진군,2013년,51953 ,24256 ,2.14,25642 ,26311 ,0.97
예천군,2013년,45573 ,21385 ,2.13,22395 ,23178 ,0.97
성주군,2013년,45067 ,20686 ,2.18,23102 ,21965 ,1.05
청도군,2013년,43788 ,20830 ,2.1,21314 ,22474 ,0.95
영덕군,2013년,40142 ,20076 ,2,19118 ,21024 ,0.91
고령군,2013년,35198 ,16059 ,2.19,17988 ,17210 ,1.05
봉화군,2013년,33894 ,16011 ,2.12,16859 ,17035 ,0.99
청송군,2013년,26470 ,13023 ,2.03,13134 ,13336 ,0.98
군위군,2013년,24172 ,11896 ,2.03,12089 ,12083 ,1
영양군,2013년,18297 ,8825 ,2.07,8996 ,9301 ,0.97
울릉군,2013년,10524 ,5400 ,1.95,5573 ,4951 ,1.13
포항시,2014년,519368 ,207515 ,2.5,263070 ,256298 ,1.03
구미시,2014년,420320 ,166686 ,2.52,214452 ,205868 ,1.04
포항시 북구,2014년,271719 ,106442 ,2.55,135624 ,136095 ,1
경주시,2014년,261535 ,111848 ,2.34,130820 ,130715 ,1
경산시,2014년,253968 ,103935 ,2.44,127909 ,126059 ,1.01
포항시 남구,2014년,247649 ,101073 ,2.45,127446 ,120203 ,1.06
안동시,2014년,168697 ,71881 ,2.35,83240 ,85457 ,0.97
김천시,2014년,135456 ,57275 ,2.37,67355 ,68101 ,0.99
칠곡군,2014년,122058 ,52555 ,2.32,63281 ,58777 ,1.08
영주시,2014년,110780 ,48093 ,2.3,55109 ,55671 ,0.99
상주시,2014년,102892 ,45845 ,2.24,50485 ,52407 ,0.96
영천시,2014년,100689 ,46355 ,2.17,50619 ,50070 ,1.01
문경시,2014년,75911 ,34159 ,2.22,37231 ,38680 ,0.96
의성군,2014년,55212 ,27352 ,2.02,26922 ,28290 ,0.95
울진군,2014년,52104 ,24590 ,2.12,25825 ,26279 ,0.98
예천군,2014년,45104 ,21394 ,2.11,22145 ,22959 ,0.96
성주군,2014년,44981 ,20989 ,2.14,23007 ,21974 ,1.05
청도군,2014년,43993 ,21211 ,2.07,21448 ,22545 ,0.95
영덕군,2014년,39586 ,20006 ,1.98,18846 ,20740 ,0.91
고령군,2014년,35033 ,16163 ,2.17,17847 ,17186 ,1.04
봉화군,2014년,34023 ,16268 ,2.09,16911 ,17112 ,0.99
청송군,2014년,26453 ,13220 ,2,13119 ,13334 ,0.98
군위군,2014년,24170 ,12038 ,2.01,12120 ,12050 ,1.01
영양군,2014년,18197 ,8817 ,2.06,8944 ,9253 ,0.97
울릉군,2014년,10264 ,5364 ,1.91,5477 ,4787 ,1.14
포항시,2015년,519584 ,210690 ,2.47,262814 ,256770 ,1.02
구미시,2015년,419915 ,167635 ,2.5,214528 ,205387 ,1.04
포항시 북구,2015년,273139 ,108518 ,2.52,136090 ,137049 ,0.99
경주시,2015년,259773 ,112609 ,2.31,130055 ,129718 ,1
경산시,2015년,256888 ,106495 ,2.41,129290 ,127598 ,1.01
포항시 남구,2015년,246445 ,102172 ,2.41,126724 ,119721 ,1.06
안동시,2015년,169221 ,73108 ,2.31,83491 ,85730 ,0.97
김천시,2015년,140132 ,60757 ,2.31,70004 ,70128 ,1
칠곡군,2015년,122829 ,53174 ,2.31,63611 ,59218 ,1.07
영주시,2015년,109735 ,48186 ,2.28,54518 ,55217 ,0.99
상주시,2015년,102374 ,46313 ,2.21,50084 ,52290 ,0.96
영천시,2015년,100648 ,47110 ,2.14,50641 ,50007 ,1.01
문경시,2015년,75784 ,34625 ,2.19,37131 ,38653 ,0.96
의성군,2015년,54477 ,27398 ,1.99,26575 ,27902 ,0.95
울진군,2015년,51885 ,24926 ,2.08,25813 ,26072 ,0.99
성주군,2015년,45029 ,21444 ,2.1,23076 ,21953 ,1.05
예천군,2015년,44674 ,21395 ,2.09,21895 ,22779 ,0.96
청도군,2015년,43724 ,21493 ,2.03,21382 ,22342 ,0.96
영덕군,2015년,39191 ,20039 ,1.96,18625 ,20566 ,0.91
고령군,2015년,34594 ,16218 ,2.13,17630 ,16964 ,1.04
봉화군,2015년,33808 ,16409 ,2.06,16774 ,17034 ,0.98
청송군,2015년,26384 ,13332 ,1.98,13054 ,13330 ,0.98
군위군,2015년,24126 ,12189 ,1.98,12077 ,12049 ,1
영양군,2015년,17898 ,8784 ,2.04,8803 ,9095 ,0.97
울릉군,2015년,10153 ,5319 ,1.91,5435 ,4718 ,1.15
포항시,2016년,516775 ,212095 ,2.44,261105 ,255670 ,1.02
구미시,2016년,419891 ,168487 ,2.49,214600 ,205291 ,1.05
포항시 북구,2016년,272027 ,109410 ,2.49,135294 ,136733 ,0.99
경주시,2016년,259452 ,113798 ,2.28,129944 ,129508 ,1
경산시,2016년,258037 ,107821 ,2.39,130060 ,127977 ,1.02
포항시 남구,2016년,244748 ,102685 ,2.38,125811 ,118937 ,1.06
안동시,2016년,168798 ,73714 ,2.29,83341 ,85457 ,0.98
김천시,2016년,142256 ,62202 ,2.29,71201 ,71055 ,1
칠곡군,2016년,123199 ,53695 ,2.29,64002 ,59197 ,1.08
영주시,2016년,109247 ,48678 ,2.24,54245 ,55002 ,0.99
상주시,2016년,101799 ,46750 ,2.18,49824 ,51975 ,0.96
영천시,2016년,100521 ,47509 ,2.12,50644 ,49877 ,1.02
문경시,2016년,74702 ,34643 ,2.16,36537 ,38165 ,0.96
의성군,2016년,54014 ,27440 ,1.97,26334 ,27680 ,0.95
울진군,2016년,51738 ,25186 ,2.05,25847 ,25891 ,1
예천군,2016년,46166 ,22123 ,2.09,22663 ,23503 ,0.96
성주군,2016년,45205 ,21877 ,2.07,23166 ,22039 ,1.05
청도군,2016년,43564 ,21722 ,2.01,21278 ,22286 ,0.95
영덕군,2016년,39052 ,20185 ,1.93,18607 ,20445 ,0.91
고령군,2016년,34257 ,16215 ,2.11,17485 ,16772 ,1.04
봉화군,2016년,33539 ,16492 ,2.03,16667 ,16872 ,0.99
청송군,2016년,26301 ,13460 ,1.95,13008 ,13293 ,0.98
군위군,2016년,24171 ,12428 ,1.94,12156 ,12015 ,1.01
영양군,2016년,17713 ,8800 ,2.01,8724 ,8989 ,0.97
울릉군,2016년,10001 ,5323 ,1.88,5430 ,4571 ,1.19
포항시,2017년,513832 ,214012 ,2.4,259491 ,254341 ,1.02
구미시,2017년,421799 ,171387 ,2.46,215826 ,205973 ,1.05
포항시 북구,2017년,271363 ,110895 ,2.45,134938 ,136425 ,0.99
경산시,2017년,259485 ,109849 ,2.36,130775 ,128710 ,1.02
경주시,2017년,257903 ,114942 ,2.24,129178 ,128725 ,1
포항시 남구,2017년,242469 ,103117 ,2.35,124553 ,117916 ,1.06
안동시,2017년,166272 ,73816 ,2.25,82143 ,84129 ,0.98
김천시,2017년,142908 ,63360 ,2.26,71556 ,71352 ,1
칠곡군,2017년,120864 ,52993 ,2.28,62820 ,58044 ,1.08
영주시,2017년,108371 ,48845 ,2.22,53737 ,54634 ,0.98
상주시,2017년,100947 ,47048 ,2.15,49344 ,51603 ,0.96
영천시,2017년,100615 ,48564 ,2.07,50857 ,49758 ,1.02
문경시,2017년,73294 ,34555 ,2.12,35907 ,37387 ,0.96
의성군,2017년,53474 ,27574 ,1.94,26102 ,27372 ,0.95
울진군,2017년,50974 ,25148 ,2.03,25463 ,25511 ,1
예천군,2017년,49253 ,23504 ,2.1,24246 ,25007 ,0.97
성주군,2017년,45138 ,22389 ,2.02,23191 ,21947 ,1.06
청도군,2017년,43346 ,21912 ,1.98,21221 ,22125 ,0.96
영덕군,2017년,38529 ,20045 ,1.92,18360 ,20169 ,0.91
고령군,2017년,33768 ,16241 ,2.08,17200 ,16568 ,1.04
봉화군,2017년,33259 ,16583 ,2.01,16550 ,16709 ,0.99
청송군,2017년,26006 ,13562 ,1.92,12891 ,13115 ,0.98
군위군,2017년,24215 ,12670 ,1.91,12247 ,11968 ,1.02
영양군,2017년,17479 ,8827 ,1.98,8618 ,8861 ,0.97
울릉군,2017년,9975 ,5435 ,1.84,5441 ,4534 ,1.2
포항시,2018년,510013 ,216654 ,2.35,257789 ,252224 ,1.02
구미시,2018년,421494 ,173269 ,2.43,215863 ,205631 ,1.05
포항시 북구,2018년,270613 ,112767 ,2.4,134567 ,136046 ,0.99
경산시,2018년,261093 ,112513 ,2.32,131537 ,129556 ,1.02
경주시,2018년,256864 ,116805 ,2.2,128802 ,128062 ,1.01
포항시 남구,2018년,239400 ,103887 ,2.3,123222 ,116178 ,1.06
안동시,2018년,162180 ,73863 ,2.2,80204 ,81976 ,0.98
김천시,2018년,141104 ,63443 ,2.22,70663 ,70441 ,1
칠곡군,2018년,118828 ,52599 ,2.26,61923 ,56905 ,1.09
영주시,2018년,106801 ,48982 ,2.18,52941 ,53860 ,0.98
영천시,2018년,101595 ,50020 ,2.03,51453 ,50142 ,1.03
상주시,2018년,100297 ,47527 ,2.11,49046 ,51251 ,0.96
문경시,2018년,71874 ,34644 ,2.07,35174 ,36700 ,0.96
예천군,2018년,53274 ,25273 ,2.11,26170 ,27104 ,0.97
의성군,2018년,52944 ,27822 ,1.9,25838 ,27106 ,0.95
울진군,2018년,50036 ,25137 ,1.99,24983 ,25053 ,1
성주군,2018년,44672 ,22677 ,1.97,23011 ,21661 ,1.06
청도군,2018년,43057 ,22181 ,1.94,21117 ,21940 ,0.96
영덕군,2018년,38108 ,20123 ,1.89,18103 ,20005 ,0.9
고령군,2018년,32969 ,16204 ,2.03,16818 ,16151 ,1.04
봉화군,2018년,32843 ,16705 ,1.97,16409 ,16434 ,1
청송군,2018년,25678 ,13723 ,1.87,12762 ,12916 ,0.99
군위군,2018년,23919 ,12784 ,1.87,12188 ,11731 ,1.04
영양군,2018년,17356 ,8913 ,1.95,8567 ,8789 ,0.97
울릉군,2018년,9832 ,5490 ,1.79,5328 ,4504 ,1.18
포항시,2019년,507025 ,220328 ,2.3,256140 ,250885 ,1.02
구미시,2019년,419742 ,176015 ,2.38,215208 ,204534 ,1.05
포항시 북구,2019년,271392 ,115504 ,2.35,134879 ,136513 ,0.99
경산시,2019년,263185 ,115537 ,2.28,132616 ,130569 ,1.02
경주시,2019년,255402 ,118542 ,2.15,127928 ,127474 ,1
포항시 남구,2019년,235633 ,104824 ,2.25,121261 ,114372 ,1.06
안동시,2019년,160052 ,74827 ,2.14,79239 ,80813 ,0.98
김천시,2019년,141229 ,65273 ,2.16,70743 ,70486 ,1
칠곡군,2019년,117047 ,52659 ,2.22,61063 ,55984 ,1.09
영주시,2019년,105067 ,49063 ,2.14,52060 ,53007 ,0.98
영천시,2019년,102470 ,51439 ,1.99,52100 ,50370 ,1.03
상주시,2019년,100688 ,48796 ,2.06,49378 ,51310 ,0.96
문경시,2019년,72242 ,35587 ,2.03,35391 ,36851 ,0.96
예천군,2019년,55100 ,26453 ,2.08,27032 ,28068 ,0.96
의성군,2019년,52595 ,28212 ,1.86,25720 ,26875 ,0.96
울진군,2019년,49314 ,25244 ,1.95,24658 ,24656 ,1
성주군,2019년,44015 ,22915 ,1.92,22716 ,21299 ,1.07
청도군,2019년,42910 ,22473 ,1.91,21065 ,21845 ,0.96
영덕군,2019년,37361 ,20085 ,1.86,17777 ,19584 ,0.91
고령군,2019년,32373 ,16227 ,2,16548 ,15825 ,1.05
봉화군,2019년,32150 ,16705 ,1.92,16146 ,16004 ,1.01
청송군,2019년,25416 ,13862 ,1.83,12694 ,12722 ,1
군위군,2019년,23843 ,12938 ,1.84,12166 ,11677 ,1.04
영양군,2019년,16993 ,8942 ,1.9,8419 ,8574 ,0.98
울릉군,2019년,9617 ,5426 ,1.77,5230 ,4387 ,1.19
포항시,2020년,502916 ,225693 ,2.23,254222 ,248694 ,1.02
구미시,2020년,416328 ,179889 ,2.31,213720 ,202608 ,1.05
포항시 북구,2020년,272494 ,119668 ,2.28,135455 ,137039 ,0.99
경산시,2020년,263728 ,119680 ,2.2,132805 ,130923 ,1.01
경주시,2020년,253502 ,121505 ,2.09,126911 ,126591 ,1
포항시 남구,2020년,230422 ,106025 ,2.17,118767 ,111655 ,1.06
안동시,2020년,158907 ,76915 ,2.07,78661 ,80246 ,0.98
김천시,2020년,140548 ,67122 ,2.09,70525 ,70023 ,1.01
칠곡군,2020년,114758 ,53026 ,2.16,59828 ,54930 ,1.09
영주시,2020년,103119 ,49718 ,2.07,51070 ,52049 ,0.98
영천시,2020년,102015 ,52861 ,1.93,51812 ,50203 ,1.03
상주시,2020년,97228 ,48856 ,1.99,47634 ,49594 ,0.96
문경시,2020년,71406 ,36268 ,1.97,35000 ,36406 ,0.96
예천군,2020년,55613 ,27301 ,2.04,27352 ,28261 ,0.97
의성군,2020년,51724 ,28750 ,1.8,25265 ,26459 ,0.95
울진군,2020년,48716 ,25562 ,1.91,24441 ,24275 ,1.01
성주군,2020년,43414 ,23516 ,1.85,22473 ,20941 ,1.07
청도군,2020년,42263 ,22843 ,1.85,20775 ,21488 ,0.97
영덕군,2020년,36313 ,20153 ,1.8,17197 ,19116 ,0.9
봉화군,2020년,31494 ,16908 ,1.86,15853 ,15641 ,1.01
고령군,2020년,31361 ,16497 ,1.9,16074 ,15287 ,1.05
청송군,2020년,25044 ,14064 ,1.78,12482 ,12562 ,0.99
군위군,2020년,23256 ,13096 ,1.78,11892 ,11364 ,1.05
영양군,2020년,16692 ,9127 ,1.83,8263 ,8429 ,0.98
울릉군,2020년,9077 ,5312 ,1.71,4956 ,4121 ,1.2
포항시,2021년,503852 ,232201 ,2.17,255292 ,248560 ,1.03
구미시,2021년,412581 ,182645 ,2.26,212021 ,200560 ,1.06
포항시 북구,2021년,273051 ,122782 ,2.22,135854 ,137197 ,0.99
경산시,2021년,268369 ,124869 ,2.15,134940 ,133429 ,1.01
경주시,2021년,251889 ,123071 ,2.05,126024 ,125865 ,1
포항시 남구,2021년,230801 ,109419 ,2.11,119438 ,111363 ,1.07
안동시,2021년,156972 ,77666 ,2.02,77590 ,79382 ,0.98
김천시,2021년,140239 ,68393 ,2.05,70305 ,69934 ,1.01
칠곡군,2021년,113822 ,53883 ,2.11,59260 ,54562 ,1.09
영주시,2021년,101942 ,50271 ,2.03,50591 ,51351 ,0.99
영천시,2021년,101888 ,53904 ,1.89,51737 ,50151 ,1.03
상주시,2021년,95566 ,48965 ,1.95,46869 ,48697 ,0.96
문경시,2021년,71154 ,37069 ,1.92,34919 ,36235 ,0.96
예천군,2021년,55739 ,27771 ,2.01,27391 ,28348 ,0.97
의성군,2021년,50632 ,28798 ,1.76,24796 ,25836 ,0.96
울진군,2021년,47858 ,25535 ,1.87,24026 ,23832 ,1.01
성주군,2021년,42842 ,23621 ,1.81,22216 ,20626 ,1.08
청도군,2021년,41891 ,23251 ,1.8,20598 ,21293 ,0.97
영덕군,2021년,35314 ,19895 ,1.78,16777 ,18537 ,0.91
봉화군,2021년,30762 ,16882 ,1.82,15551 ,15211 ,1.02
고령군,2021년,30626 ,16556 ,1.85,15741 ,14885 ,1.06
청송군,2021년,24539 ,14029 ,1.75,12261 ,12278 ,1
군위군,2021년,22945 ,13258 ,1.73,11761 ,11184 ,1.05
영양군,2021년,16320 ,9055 ,1.8,8144 ,8176 ,1
울릉군,2021년,8867 ,5258 ,1.69,4851 ,4016 ,1.21
포항시,2022년,496650 ,232371 ,2.14,251630 ,245020 ,1.03
구미시,2022년,408110 ,184786 ,2.21,209909 ,198201 ,1.06
포항시 북구,2022년,269164 ,122839 ,2.19,133845 ,135319 ,0.99
경산시,2022년,267725 ,127392 ,2.1,134746 ,132979 ,1.01
경주시,2022년,249607 ,124027 ,2.01,124909 ,124698 ,1
포항시 남구,2022년,227486 ,109532 ,2.08,117785 ,109701 ,1.07
안동시,2022년,154610 ,77759 ,1.99,76447 ,78163 ,0.98
김천시,2022년,139324 ,69038 ,2.02,69900 ,69424 ,1.01
칠곡군,2022년,112487 ,54443 ,2.07,58821 ,53666 ,1.1
영천시,2022년,101088 ,54431 ,1.86,51406 ,49682 ,1.03
영주시,2022년,100749 ,50663 ,1.99,49920 ,50829 ,0.98
상주시,2022년,94823 ,49315 ,1.92,46660 ,48163 ,0.97
문경시,2022년,70373 ,37056 ,1.9,34577 ,35796 ,0.97
예천군,2022년,55755 ,28155 ,1.98,27400 ,28355 ,0.97
의성군,2022년,50186 ,29005 ,1.73,24709 ,25477 ,0.97
울진군,2022년,47030 ,25462 ,1.85,23687 ,23343 ,1.01
성주군,2022년,42566 ,23918 ,1.78,22161 ,20405 ,1.09
청도군,2022년,41614 ,23443 ,1.78,20541 ,21073 ,0.97
영덕군,2022년,34650 ,19741 ,1.76,16481 ,18169 ,0.91
고령군,2022년,30353 ,16758 ,1.81,15572 ,14781 ,1.05
봉화군,2022년,30139 ,16830 ,1.79,15295 ,14844 ,1.03
청송군,2022년,24295 ,14038 ,1.73,12168 ,12127 ,1
군위군,2022년,23340 ,13693 ,1.7,11969 ,11371 ,1.05
영양군,2022년,16022 ,9070 ,1.77,7997 ,8025 ,1
울릉군,2022년,8996 ,5479 ,1.64,4976 ,4020 ,1.24
포항시,2023년,493033 ,233932 ,2.11,250242 ,242791 ,1.03
구미시,2023년,405506 ,187139 ,2.17,209131 ,196375 ,1.06
포항시 북구,2023년,266755 ,123293 ,2.16,132733 ,134022 ,0.99
경산시,2023년,266205 ,129264 ,2.06,133847 ,132358 ,1.01
경주시,2023년,247489 ,124577 ,1.99,123906 ,123583 ,1
포항시 남구,2023년,226278 ,110639 ,2.05,117509 ,108769 ,1.08
안동시,2023년,152935 ,78283 ,1.95,75538 ,77397 ,0.98
김천시,2023년,137515 ,69125 ,1.99,69082 ,68433 ,1.01
칠곡군,2023년,110581 ,54578 ,2.03,57966 ,52615 ,1.1
영천시,2023년,100212 ,54976 ,1.82,51137 ,49075 ,1.04
영주시,2023년,100199 ,51423 ,1.95,49730 ,50469 ,0.99
상주시,2023년,93858 ,49493 ,1.9,46166 ,47692 ,0.97
문경시,2023년,68755 ,36814 ,1.87,33775 ,34980 ,0.97
예천군,2023년,55325 ,28145 ,1.97,27224 ,28101 ,0.97
의성군,2023년,50086 ,29471 ,1.7,24808 ,25278 ,0.98
울진군,2023년,46669 ,25527 ,1.83,23553 ,23116 ,1.02
성주군,2023년,42086 ,24059 ,1.75,22000 ,20086 ,1.1
청도군,2023년,41316 ,23525 ,1.76,20493 ,20823 ,0.98
영덕군,2023년,34055 ,19725 ,1.73,16232 ,17823 ,0.91
고령군,2023년,30139 ,17023 ,1.77,15477 ,14662 ,1.06
봉화군,2023년,29603 ,16823 ,1.76,15090 ,14513 ,1.04
청송군,2023년,24019 ,13999 ,1.72,12063 ,11956 ,1.01
영양군,2023년,15661 ,8994 ,1.74,7805 ,7856 ,0.99
울릉군,2023년,9077 ,5605 ,1.62,5033 ,4044 ,1.24
포항시,2024년,491581 ,237089 ,2.07,249710 ,241871 ,1.03
구미시,2024년,404820 ,190392 ,2.13,209069 ,195751 ,1.07
포항시 북구,2024년,270968 ,127350 ,2.13,135113 ,135855 ,0.99
경산시,2024년,266398 ,131633 ,2.02,133851 ,132547 ,1.01
경주시,2024년,244769 ,124985 ,1.96,122608 ,122161 ,1
포항시 남구,2024년,220613 ,109739 ,2.01,114597 ,106016 ,1.08
안동시,2024년,153159 ,80157 ,1.91,75871 ,77288 ,0.98
김천시,2024년,135446 ,69000 ,1.96,68101 ,67345 ,1.01
칠곡군,2024년,107383 ,53873 ,1.99,56390 ,50993 ,1.11
영주시,2024년,98870 ,51571 ,1.92,49141 ,49729 ,0.99
영천시,2024년,98143 ,54862 ,1.79,50226 ,47917 ,1.05
상주시,2024년,91850 ,49163 ,1.87,45315 ,46535 ,0.97
문경시,2024년,67257 ,36638 ,1.84,33041 ,34216 ,0.97
예천군,2024년,54609 ,27988 ,1.95,26929 ,27680 ,0.97
의성군,2024년,48690 ,29104 ,1.67,24244 ,24446 ,0.99
울진군,2024년,46124 ,25584 ,1.8,23392 ,22732 ,1.03
성주군,2024년,41452 ,24108 ,1.72,21672 ,19780 ,1.1
청도군,2024년,40582 ,23427 ,1.73,20193 ,20389 ,0.99
영덕군,2024년,33210 ,19486 ,1.7,15902 ,17308 ,0.92
고령군,2024년,30062 ,17301 ,1.74,15507 ,14555 ,1.07
봉화군,2024년,28836 ,16600 ,1.74,14720 ,14116 ,1.04
청송군,2024년,23716 ,13985 ,1.7,11905 ,11811 ,1.01
영양군,2024년,15328 ,8954 ,1.71,7639 ,7689 ,0.99
울릉군,2024년,9099 ,5668 ,1.61,5121 ,3978 ,1.29
